8
6
##....##
.##..##.
..####..
..####..
.##..##.
##....##